"filename", "language", "Java", "YAML", "XML", "comment", "blank", "total"
"c:\Users\gaolu\twitterplusp\src\main\java\com\twitter\twitterplusp\TwitterpluspApplication.java", "Java", 13, 0, 0, 0, 5, 18
"c:\Users\gaolu\twitterplusp\src\main\java\com\twitter\twitterplusp\common\CustomException.java", "Java", 6, 0, 0, 3, 5, 14
"c:\Users\gaolu\twitterplusp\src\main\java\com\twitter\twitterplusp\common\GlobalExceptionHandler.java", "Java", 48, 0, 0, 12, 12, 72
"c:\Users\gaolu\twitterplusp\src\main\java\com\twitter\twitterplusp\common\MyMetaObjectHandler.java", "Java", 19, 0, 0, 8, 7, 34
"c:\Users\gaolu\twitterplusp\src\main\java\com\twitter\twitterplusp\common\R.java", "Java", 33, 0, 0, 4, 12, 49
"c:\Users\gaolu\twitterplusp\src\main\java\com\twitter\twitterplusp\common\TokenOverdueException.java", "Java", 0, 0, 0, 12, 1, 13
"c:\Users\gaolu\twitterplusp\src\main\java\com\twitter\twitterplusp\config\MybatisPlusConfig.java", "Java", 14, 0, 0, 3, 5, 22
"c:\Users\gaolu\twitterplusp\src\main\java\com\twitter\twitterplusp\config\OriginConfig.java", "Java", 9, 0, 0, 9, 3, 21
"c:\Users\gaolu\twitterplusp\src\main\java\com\twitter\twitterplusp\config\RedisConfig.java", "Java", 24, 0, 0, 2, 7, 33
"c:\Users\gaolu\twitterplusp\src\main\java\com\twitter\twitterplusp\config\SecurityConfig.java", "Java", 52, 0, 0, 39, 14, 105
"c:\Users\gaolu\twitterplusp\src\main\java\com\twitter\twitterplusp\controller\CommentController.java", "Java", 33, 0, 0, 12, 15, 60
"c:\Users\gaolu\twitterplusp\src\main\java\com\twitter\twitterplusp\controller\CommonController.java", "Java", 34, 0, 0, 34, 11, 79
"c:\Users\gaolu\twitterplusp\src\main\java\com\twitter\twitterplusp\controller\LikeController.java", "Java", 39, 0, 0, 12, 9, 60
"c:\Users\gaolu\twitterplusp\src\main\java\com\twitter\twitterplusp\controller\LoginController.java", "Java", 22, 0, 0, 9, 9, 40
"c:\Users\gaolu\twitterplusp\src\main\java\com\twitter\twitterplusp\controller\PersonalHomePageController.java", "Java", 20, 0, 0, 5, 8, 33
"c:\Users\gaolu\twitterplusp\src\main\java\com\twitter\twitterplusp\controller\TweetController.java", "Java", 40, 0, 0, 15, 15, 70
"c:\Users\gaolu\twitterplusp\src\main\java\com\twitter\twitterplusp\controller\UserController.java", "Java", 36, 0, 0, 22, 19, 77
"c:\Users\gaolu\twitterplusp\src\main\java\com\twitter\twitterplusp\dto\CommentDto.java", "Java", 15, 0, 0, 2, 8, 25
"c:\Users\gaolu\twitterplusp\src\main\java\com\twitter\twitterplusp\dto\TweetDto.java", "Java", 12, 0, 0, 0, 10, 22
"c:\Users\gaolu\twitterplusp\src\main\java\com\twitter\twitterplusp\entity\Comment.java", "Java", 18, 0, 0, 1, 10, 29
"c:\Users\gaolu\twitterplusp\src\main\java\com\twitter\twitterplusp\entity\Like.java", "Java", 13, 0, 0, 3, 8, 24
"c:\Users\gaolu\twitterplusp\src\main\java\com\twitter\twitterplusp\entity\LoginUser.java", "Java", 56, 0, 0, 7, 15, 78
"c:\Users\gaolu\twitterplusp\src\main\java\com\twitter\twitterplusp\entity\Menu.java", "Java", 32, 0, 0, 33, 8, 73
"c:\Users\gaolu\twitterplusp\src\main\java\com\twitter\twitterplusp\entity\Tweet.java", "Java", 21, 0, 0, 1, 15, 37
"c:\Users\gaolu\twitterplusp\src\main\java\com\twitter\twitterplusp\entity\User.java", "Java", 20, 0, 0, 1, 16, 37
"c:\Users\gaolu\twitterplusp\src\main\java\com\twitter\twitterplusp\entity\UserRole.java", "Java", 15, 0, 0, 0, 6, 21
"c:\Users\gaolu\twitterplusp\src\main\java\com\twitter\twitterplusp\filter\JwtAuthenticationTokenFilter.java", "Java", 48, 0, 0, 6, 7, 61
"c:\Users\gaolu\twitterplusp\src\main\java\com\twitter\twitterplusp\handler\AccessDeniedHandlerImpl.java", "Java", 21, 0, 0, 0, 4, 25
"c:\Users\gaolu\twitterplusp\src\main\java\com\twitter\twitterplusp\handler\AuthenticationEntryPointImpl.java", "Java", 21, 0, 0, 4, 3, 28
"c:\Users\gaolu\twitterplusp\src\main\java\com\twitter\twitterplusp\mapper\CommentMapper.java", "Java", 9, 0, 0, 0, 3, 12
"c:\Users\gaolu\twitterplusp\src\main\java\com\twitter\twitterplusp\mapper\LikeMapper.java", "Java", 7, 0, 0, 0, 3, 10
"c:\Users\gaolu\twitterplusp\src\main\java\com\twitter\twitterplusp\mapper\LoginMapper.java", "Java", 9, 0, 0, 0, 6, 15
"c:\Users\gaolu\twitterplusp\src\main\java\com\twitter\twitterplusp\mapper\MenuMapper.java", "Java", 9, 0, 0, 0, 6, 15
"c:\Users\gaolu\twitterplusp\src\main\java\com\twitter\twitterplusp\mapper\PersonalHomePageMapper.java", "Java", 7, 0, 0, 0, 3, 10
"c:\Users\gaolu\twitterplusp\src\main\java\com\twitter\twitterplusp\mapper\TweetMapper.java", "Java", 7, 0, 0, 0, 3, 10
"c:\Users\gaolu\twitterplusp\src\main\java\com\twitter\twitterplusp\mapper\UserMapper.java", "Java", 9, 0, 0, 0, 3, 12
"c:\Users\gaolu\twitterplusp\src\main\java\com\twitter\twitterplusp\mapper\UserRoleMapper.java", "Java", 7, 0, 0, 0, 3, 10
"c:\Users\gaolu\twitterplusp\src\main\java\com\twitter\twitterplusp\service\CommentService.java", "Java", 9, 0, 0, 4, 6, 19
"c:\Users\gaolu\twitterplusp\src\main\java\com\twitter\twitterplusp\service\LikeService.java", "Java", 9, 0, 0, 10, 5, 24
"c:\Users\gaolu\twitterplusp\src\main\java\com\twitter\twitterplusp\service\LoginService.java", "Java", 8, 0, 0, 9, 6, 23
"c:\Users\gaolu\twitterplusp\src\main\java\com\twitter\twitterplusp\service\PersonalHomePageService.java", "Java", 8, 0, 0, 0, 3, 11
"c:\Users\gaolu\twitterplusp\src\main\java\com\twitter\twitterplusp\service\TweetService.java", "Java", 14, 0, 0, 5, 8, 27
"c:\Users\gaolu\twitterplusp\src\main\java\com\twitter\twitterplusp\service\UserRoleService.java", "Java", 5, 0, 0, 0, 3, 8
"c:\Users\gaolu\twitterplusp\src\main\java\com\twitter\twitterplusp\service\UserService.java", "Java", 13, 0, 0, 9, 12, 34
"c:\Users\gaolu\twitterplusp\src\main\java\com\twitter\twitterplusp\service\impl\CommentServiceImpl.java", "Java", 85, 0, 0, 19, 27, 131
"c:\Users\gaolu\twitterplusp\src\main\java\com\twitter\twitterplusp\service\impl\LikeServiceImpl.java", "Java", 97, 0, 0, 17, 31, 145
"c:\Users\gaolu\twitterplusp\src\main\java\com\twitter\twitterplusp\service\impl\LoginServiceImpl.java", "Java", 49, 0, 0, 24, 13, 86
"c:\Users\gaolu\twitterplusp\src\main\java\com\twitter\twitterplusp\service\impl\PersonalHomePageServiceImpl.java", "Java", 28, 0, 0, 0, 6, 34
"c:\Users\gaolu\twitterplusp\src\main\java\com\twitter\twitterplusp\service\impl\TweetServiceImpl.java", "Java", 157, 0, 0, 26, 46, 229
"c:\Users\gaolu\twitterplusp\src\main\java\com\twitter\twitterplusp\service\impl\UserDetailsServiceImpl.java", "Java", 32, 0, 0, 3, 10, 45
"c:\Users\gaolu\twitterplusp\src\main\java\com\twitter\twitterplusp\service\impl\UserRoleServiceImpl.java", "Java", 9, 0, 0, 0, 3, 12
"c:\Users\gaolu\twitterplusp\src\main\java\com\twitter\twitterplusp\service\impl\UserServiceImpl.java", "Java", 100, 0, 0, 22, 26, 148
"c:\Users\gaolu\twitterplusp\src\main\java\com\twitter\twitterplusp\utils\FastJsonRedisSerializer.java", "Java", 46, 0, 0, 5, 11, 62
"c:\Users\gaolu\twitterplusp\src\main\java\com\twitter\twitterplusp\utils\GetLoginUserInfo.java", "Java", 13, 0, 0, 4, 9, 26
"c:\Users\gaolu\twitterplusp\src\main\java\com\twitter\twitterplusp\utils\JwtUtil.java", "Java", 67, 0, 0, 38, 14, 119
"c:\Users\gaolu\twitterplusp\src\main\java\com\twitter\twitterplusp\utils\RedisCache.java", "Java", 100, 0, 0, 117, 21, 238
"c:\Users\gaolu\twitterplusp\src\main\java\com\twitter\twitterplusp\utils\Upload.java", "Java", 44, 0, 0, 12, 14, 70
"c:\Users\gaolu\twitterplusp\src\main\java\com\twitter\twitterplusp\utils\WebUtils.java", "Java", 20, 0, 0, 7, 2, 29
"c:\Users\gaolu\twitterplusp\src\main\resources\application.yml", "YAML", 0, 37, 0, 10, 7, 54
"c:\Users\gaolu\twitterplusp\src\main\resources\mapper\MenuMapper.xml", "XML", 0, 0, 13, 0, 2, 15
"c:\Users\gaolu\twitterplusp\src\test\java\com\twitter\twitterplusp\TwitterpluspApplicationTests.java", "Java", 17, 0, 0, 0, 7, 24
"Total", "-", 1728, 37, 13, 600, 589, 2967